1111111111
1P1C0011E1
1001000C01
100000C001
11C000C001
1111111111