111111111111
1P1C0C010C01
10C1000C0001
1001001000C1
11C001C000E1
111111111111